#,Open_Time,Direction,Entry_Price,Stop_Loss,Take_Profit,RR,Balance_Before,Risk_Amount,Position_Size,Close_Time,Balance_After,Profit,Result
1,2023-08-18 17:20:00,Long,1.08704,1.08704,1.08704,2,10000,100,,2023-08-18 17:20:00,10200,200,Win
2,2023-08-21 12:20:00,Long,1.09003,1.08996,1.09017,2,10200,100,,2023-08-21 12:20:00,10400,200,Win
3,2023-08-22 12:35:00,Long,1.08803,1.08757,1.0889500000000003,2,10400,100,,2023-08-22 12:35:00,10300,-100,Lose
4,2023-08-23 12:25:00,Long,1.08056,1.08044,1.0807999999999998,2,10300,100,,2023-08-23 12:25:00,10300,0,BreakEven
5,2023-08-24 11:40:00,Long,1.08496,1.08496,1.08496,2,10300,100,,2023-08-24 11:40:00,10500,200,Win
6,2023-08-25 14:25:00,Long,1.07902,1.07899,1.0790800000000005,2,10500,100,,2023-08-25 14:25:00,10700,200,Win
7,2023-08-28 15:15:00,Long,1.08053,1.08047,1.0806499999999999,2,10700,100,,2023-08-28 15:15:00,10900,200,Win
8,2023-08-29 08:15:00,Long,1.08118,1.08118,1.08118,2,10900,100,,2023-08-29 08:15:00,11100,200,Win
9,2023-08-30 15:00:00,Long,1.09268,1.09262,1.0928000000000004,2,11100,100,,2023-08-30 15:00:00,11300,200,Win
10,2023-08-31 11:30:00,Long,1.08621,1.08617,1.0862899999999995,2,11300,100,,2023-08-31 11:30:00,11500,200,Win
11,2023-09-04 18:55:00,Long,1.07953,1.07953,1.07953,2,11500,100,,2023-09-04 18:55:00,11700,200,Win
12,2023-09-05 13:55:00,Long,1.0729,1.07258,1.0735399999999997,2,11700,100,,2023-09-05 13:55:00,11600,-100,Lose
13,2023-09-06 09:15:00,Long,1.07284,1.07274,1.07304,2,11600,100,,2023-09-06 09:15:00,11800,200,Win
14,2023-09-07 17:35:00,Long,1.07046,1.07043,1.07052,2,11800,100,,2023-09-07 17:35:00,12000,200,Win
15,2023-09-08 11:20:00,Long,1.0698,1.0698,1.0698,2,12000,100,,2023-09-08 11:20:00,12200,200,Win
16,2023-09-11 15:45:00,Long,1.07428,1.07412,1.0745999999999998,2,12200,100,,2023-09-11 15:45:00,12100,-100,Lose
17,2023-09-12 16:55:00,Long,1.07232,1.07215,1.07266,2,12100,100,,2023-09-12 16:55:00,12000,-100,Lose
18,2023-09-13 15:35:00,Long,1.07343,1.07336,1.0735700000000001,2,12000,100,,2023-09-13 15:35:00,12200,200,Win
19,2023-09-15 10:20:00,Long,1.06641,1.0664,1.0664300000000002,2,12200,100,,2023-09-15 10:20:00,12400,200,Win
20,2023-09-18 17:50:00,Long,1.06895,1.06894,1.0689700000000002,2,12400,100,,2023-09-18 17:50:00,12600,200,Win
21,2023-09-19 09:35:00,Long,1.0684,1.0684,1.0684,2,12600,100,,2023-09-19 09:35:00,12800,200,Win
22,2023-09-20 11:45:00,Short,1.0704,1.0704,1.0704,2,12800,100,,2023-09-20 11:45:00,13000,200,Win
23,2023-09-21 09:55:00,Long,1.06534,1.06514,1.06574,2,13000,100,,2023-09-21 09:55:00,12900,-100,Lose
24,2023-09-22 16:00:00,Long,1.06588,1.06585,1.0659399999999999,2,12900,100,,2023-09-22 16:00:00,13100,200,Win
25,2023-09-26 10:20:00,Long,1.05977,1.0597,1.0599100000000001,2,13100,100,,2023-09-26 10:20:00,13100,0,BreakEven
26,2023-09-27 08:15:00,Long,1.05659,1.05626,1.0572499999999998,2,13100,100,,2023-09-27 08:15:00,13000,-100,Lose
27,2023-09-28 12:10:00,Long,1.0536,1.05344,1.0539200000000004,2,13000,100,,2023-09-28 12:10:00,13000,0,BreakEven
28,2023-09-29 10:25:00,Long,1.06092,1.0607,1.0613600000000003,2,13000,100,,2023-09-29 10:25:00,12900,-100,Lose
29,2023-10-04 11:50:00,Long,1.05024,1.05024,1.05024,2,12900,100,,2023-10-04 11:50:00,13100,200,Win
30,2023-10-05 09:55:00,Long,1.05077,1.05075,1.0508099999999998,2,13100,100,,2023-10-05 09:55:00,13300,200,Win
31,2023-10-06 11:05:00,Long,1.05521,1.05513,1.0553700000000001,2,13300,100,,2023-10-06 11:05:00,13500,200,Win
32,2023-10-09 11:55:00,Long,1.05282,1.05268,1.0531000000000001,2,13500,100,,2023-10-09 11:55:00,13500,0,BreakEven
33,2023-10-10 10:20:00,Long,1.05948,1.05946,1.0595199999999998,2,13500,100,,2023-10-10 10:20:00,13700,200,Win
34,2023-10-11 10:00:00,Long,1.06054,1.06018,1.0612600000000003,2,13700,100,,2023-10-11 10:00:00,13600,-100,Lose
35,2023-10-12 10:45:00,Long,1.06194,1.06187,1.0620800000000001,2,13600,100,,2023-10-12 10:45:00,13800,200,Win
36,2023-10-16 08:15:00,Long,1.05241,1.05235,1.0525300000000004,2,13800,100,,2023-10-16 08:15:00,14000,200,Win
37,2023-10-17 16:45:00,Long,1.0584,1.05806,1.05908,2,14000,100,,2023-10-17 16:45:00,13900,-100,Lose
38,2023-10-19 09:25:00,Long,1.0538,1.05367,1.05406,2,13900,100,,2023-10-19 09:25:00,13800,-100,Lose
39,2023-10-20 11:30:00,Short,1.05919,1.05923,1.0591100000000004,2,13800,100,,2023-10-20 11:30:00,14000,200,Win
40,2023-10-23 09:50:00,Long,1.05953,1.05907,1.0604500000000003,2,14000,100,,2023-10-23 09:50:00,13900,-100,Lose
41,2023-10-24 12:20:00,Long,1.06279,1.06237,1.0636299999999996,2,13900,100,,2023-10-24 12:20:00,13800,-100,Lose
42,2023-10-25 08:55:00,Long,1.0585,1.05834,1.0588199999999999,2,13800,100,,2023-10-25 08:55:00,13700,-100,Lose
43,2023-10-26 10:00:00,Long,1.05466,1.0545,1.0549799999999998,2,13700,100,,2023-10-26 10:00:00,13600,-100,Lose
44,2023-10-27 10:30:00,Long,1.05583,1.05573,1.05603,2,13600,100,,2023-10-27 10:30:00,13500,-100,Lose
45,2023-10-30 14:30:00,Long,1.05964,1.05909,1.0607399999999996,2,13500,100,,2023-10-30 14:30:00,13400,-100,Lose
46,2023-11-01 13:00:00,Long,1.05367,1.05334,1.0543300000000004,2,13400,100,,2023-11-01 13:00:00,13300,-100,Lose
47,2023-11-02 08:05:00,Long,1.05929,1.0591,1.0596700000000003,2,13300,100,,2023-11-02 08:05:00,13500,200,Win
48,2023-11-03 14:40:00,Long,1.07025,1.06994,1.07087,2,13500,100,,2023-11-03 14:40:00,13700,200,Win
49,2023-11-06 09:50:00,Long,1.07468,1.07435,1.0753400000000004,2,13700,100,,2023-11-06 09:50:00,13600,-100,Lose
50,2023-11-07 09:15:00,Long,1.06947,1.06924,1.0699299999999998,2,13600,100,,2023-11-07 09:15:00,13500,-100,Lose
51,2023-11-09 16:15:00,Long,1.07111,1.07105,1.07123,2,13500,100,,2023-11-09 16:15:00,13700,200,Win
52,2023-11-10 10:20:00,Long,1.0671,1.06692,1.0674599999999996,2,13700,100,,2023-11-10 10:20:00,13600,-100,Lose
53,2023-11-13 11:15:00,Long,1.06885,1.06885,1.06885,2,13600,100,,2023-11-13 11:15:00,13800,200,Win
54,2023-11-14 19:05:00,Long,1.08692,1.08678,1.0872000000000002,2,13800,100,,2023-11-14 19:05:00,13800,0,BreakEven
55,2023-11-15 13:35:00,Long,1.08512,1.08506,1.0852400000000004,2,13800,100,,2023-11-15 13:35:00,14000,200,Win
56,2023-11-17 11:45:00,Long,1.08653,1.08598,1.08763,2,14000,100,,2023-11-17 11:45:00,13900,-100,Lose
57,2023-11-20 10:25:00,Long,1.09264,1.09226,1.0934000000000001,2,13900,100,,2023-11-20 10:25:00,13800,-100,Lose
58,2023-11-21 08:20:00,Long,1.09537,1.09506,1.09599,2,13800,100,,2023-11-21 08:20:00,13700,-100,Lose
59,2023-11-22 10:30:00,Long,1.08966,1.0896,1.0897800000000004,2,13700,100,,2023-11-22 10:30:00,13900,200,Win
60,2023-11-23 08:15:00,Long,1.09076,1.08955,1.0931799999999998,2,13900,100,,2023-11-23 08:15:00,13800,-100,Lose
61,2023-11-24 08:15:00,Long,1.09054,1.09052,1.0905800000000003,2,13800,100,,2023-11-24 08:15:00,14000,200,Win
62,2023-11-27 08:00:00,Long,1.09451,1.09451,1.09451,2,14000,100,,2023-11-27 08:00:00,14200,200,Win
63,2023-11-28 10:50:00,Long,1.0948,1.09465,1.0951000000000002,2,14200,100,,2023-11-28 10:50:00,14100,-100,Lose
64,2023-11-29 15:10:00,Long,1.09721,1.09658,1.0984699999999998,2,14100,100,,2023-11-29 15:10:00,14000,-100,Lose
65,2023-11-30 16:30:00,Long,1.09056,1.09037,1.0909399999999998,2,14000,100,,2023-11-30 16:30:00,14200,200,Win
66,2023-12-01 12:45:00,Long,1.08813,1.08808,1.0882300000000003,2,14200,100,,2023-12-01 12:45:00,14400,200,Win
67,2023-12-04 18:35:00,Long,1.08181,1.08152,1.0823899999999997,2,14400,100,,2023-12-04 18:35:00,14300,-100,Lose
68,2023-12-05 14:30:00,Long,1.08166,1.08143,1.0821200000000004,2,14300,100,,2023-12-05 14:30:00,14200,-100,Lose
69,2023-12-06 11:10:00,Long,1.07873,1.07867,1.0788499999999999,2,14200,100,,2023-12-06 11:10:00,14400,200,Win
70,2023-12-07 10:05:00,Long,1.07768,1.07755,1.07794,2,14400,100,,2023-12-07 10:05:00,14600,200,Win
71,2023-12-11 09:45:00,Long,1.07604,1.07573,1.0766600000000002,2,14600,100,,2023-12-11 09:45:00,14500,-100,Lose
72,2023-12-12 18:35:00,Long,1.07888,1.07877,1.0791000000000002,2,14500,100,,2023-12-12 18:35:00,14400,-100,Lose
73,2023-12-13 09:50:00,Long,1.07848,1.07846,1.0785200000000004,2,14400,100,,2023-12-13 09:50:00,14600,200,Win
74,2023-12-14 17:05:00,Long,1.09957,1.09891,1.1008899999999997,2,14600,100,,2023-12-14 17:05:00,14500,-100,Lose
75,2023-12-15 18:10:00,Long,1.09007,1.09007,1.09007,2,14500,100,,2023-12-15 18:10:00,14700,200,Win
76,2023-12-18 08:20:00,Long,1.09182,1.09163,1.0921999999999998,2,14700,100,,2023-12-18 08:20:00,14600,-100,Lose
77,2023-12-19 19:10:00,Short,1.09767,1.09776,1.0974899999999996,2,14600,100,,2023-12-19 19:10:00,14600,0,BreakEven
78,2023-12-20 10:05:00,Long,1.09604,1.09594,1.0962399999999999,2,14600,100,,2023-12-20 10:05:00,14800,200,Win
79,2023-12-21 15:00:00,Long,1.09853,1.09849,1.09861,2,14800,100,,2023-12-21 15:00:00,15000,200,Win
80,2023-12-22 09:55:00,Long,1.10043,1.10025,1.1007900000000002,2,15000,100,,2023-12-22 09:55:00,14900,-100,Lose
81,2023-12-26 08:00:00,Long,1.10226,1.10221,1.1023600000000002,2,14900,100,,2023-12-26 08:00:00,15100,200,Win
82,2023-12-27 11:15:00,Long,1.10516,1.10511,1.1052599999999997,2,15100,100,,2023-12-27 11:15:00,15300,200,Win
83,2024-01-03 08:30:00,Long,1.09522,1.09502,1.09562,2,15300,100,,2024-01-03 08:30:00,15200,-100,Lose
84,2024-01-04 17:10:00,Long,1.09553,1.09541,1.0957699999999997,2,15200,100,,2024-01-04 17:10:00,15200,0,BreakEven
85,2024-01-05 09:50:00,Long,1.09107,1.09104,1.09113,2,15200,100,,2024-01-05 09:50:00,15400,200,Win
86,2024-01-09 08:10:00,Long,1.09427,1.09426,1.0942900000000002,2,15400,100,,2024-01-09 08:10:00,15600,200,Win
87,2024-01-10 18:30:00,Short,1.09677,1.09689,1.0965300000000002,2,15600,100,,2024-01-10 18:30:00,15500,-100,Lose
88,2024-01-11 16:55:00,Long,1.09423,1.09366,1.09537,2,15500,100,,2024-01-11 16:55:00,15400,-100,Lose
89,2024-01-15 19:55:00,Long,1.09504,1.09497,1.09518,2,15400,100,,2024-01-15 19:55:00,15300,-100,Lose
90,2024-01-16 08:10:00,Long,1.09129,1.09104,1.0917900000000003,2,15300,100,,2024-01-16 08:10:00,15200,-100,Lose
91,2024-01-17 16:30:00,Long,1.08494,1.08476,1.0853000000000002,2,15200,100,,2024-01-17 16:30:00,15400,200,Win
92,2024-01-18 11:40:00,Long,1.08877,1.08865,1.0890100000000003,2,15400,100,,2024-01-18 11:40:00,15400,0,BreakEven
93,2024-01-19 08:15:00,Long,1.08732,1.08732,1.08732,2,15400,100,,2024-01-19 08:15:00,15600,200,Win
94,2024-01-22 09:45:00,Long,1.08934,1.08923,1.08956,2,15600,100,,2024-01-22 09:45:00,15600,0,BreakEven
95,2024-01-24 08:45:00,Long,1.08695,1.08687,1.0871100000000002,2,15600,100,,2024-01-24 08:45:00,15800,200,Win
96,2024-01-25 10:30:00,Long,1.08936,1.08919,1.0897000000000001,2,15800,100,,2024-01-25 10:30:00,15700,-100,Lose
97,2024-01-26 18:00:00,Short,1.08651,1.08652,1.0864900000000004,2,15700,100,,2024-01-26 18:00:00,15900,200,Win
98,2024-01-30 13:15:00,Long,1.08391,1.08381,1.08411,2,15900,100,,2024-01-30 13:15:00,16100,200,Win
99,2024-02-01 14:15:00,Long,1.08171,1.0817,1.0817299999999996,2,16100,100,,2024-02-01 14:15:00,16300,200,Win
100,2024-02-02 18:00:00,Long,1.0782,1.07818,1.0782400000000003,2,16300,100,,2024-02-02 18:00:00,16500,200,Win
101,2024-02-05 08:25:00,Long,1.07728,1.07727,1.0773000000000001,2,16500,100,,2024-02-05 08:25:00,16700,200,Win
102,2024-02-06 08:00:00,Long,1.07528,1.07517,1.0755000000000001,2,16700,100,,2024-02-06 08:00:00,16900,200,Win
103,2024-02-07 13:55:00,Long,1.07701,1.0768,1.07743,2,16900,100,,2024-02-07 13:55:00,16800,-100,Lose
104,2024-02-09 08:50:00,Long,1.07758,1.0773,1.07814,2,16800,100,,2024-02-09 08:50:00,16700,-100,Lose
105,2024-02-12 08:15:00,Long,1.07877,1.07875,1.0788099999999998,2,16700,100,,2024-02-12 08:15:00,16900,200,Win
106,2024-02-13 08:05:00,Long,1.07695,1.07689,1.0770700000000004,2,16900,100,,2024-02-13 08:05:00,17100,200,Win
107,2024-02-14 18:15:00,Long,1.07275,1.0727,1.0728500000000003,2,17100,100,,2024-02-14 18:15:00,17300,200,Win
108,2024-02-16 08:05:00,Long,1.07606,1.07604,1.0760999999999998,2,17300,100,,2024-02-16 08:05:00,17500,200,Win
109,2024-02-19 08:00:00,Long,1.07848,1.07823,1.0789800000000003,2,17500,100,,2024-02-19 08:00:00,17400,-100,Lose
110,2024-02-20 19:15:00,Short,1.08111,1.08112,1.0810899999999999,2,17400,100,,2024-02-20 19:15:00,17600,200,Win
111,2024-02-21 08:20:00,Long,1.08084,1.08071,1.0811,2,17600,100,,2024-02-21 08:20:00,17800,200,Win
112,2024-02-23 08:45:00,Long,1.08232,1.08224,1.0824799999999997,2,17800,100,,2024-02-23 08:45:00,18000,200,Win
113,2024-02-26 13:00:00,Long,1.08499,1.08483,1.0853099999999998,2,18000,100,,2024-02-26 13:00:00,17900,-100,Lose
114,2024-02-27 18:35:00,Long,1.08524,1.0852,1.08532,2,17900,100,,2024-02-27 18:35:00,18100,200,Win
115,2024-02-28 17:40:00,Long,1.08358,1.08339,1.0839599999999998,2,18100,100,,2024-02-28 17:40:00,18000,-100,Lose
116,2024-03-01 08:50:00,Long,1.08115,1.08108,1.08129,2,18000,100,,2024-03-01 08:50:00,18200,200,Win
117,2024-03-04 08:25:00,Long,1.08419,1.08401,1.0845500000000001,2,18200,100,,2024-03-04 08:25:00,18200,0,BreakEven
118,2024-03-06 17:40:00,Long,1.09012,1.09011,1.09014,2,18200,100,,2024-03-06 17:40:00,18400,200,Win
119,2024-03-07 10:30:00,Long,1.08934,1.0893,1.08942,2,18400,100,,2024-03-07 10:30:00,18600,200,Win
120,2024-03-08 10:35:00,Long,1.09284,1.09263,1.0932600000000001,2,18600,100,,2024-03-08 10:35:00,18500,-100,Lose
121,2024-03-11 09:15:00,Long,1.09409,1.09406,1.09415,2,18500,100,,2024-03-11 09:15:00,18700,200,Win
122,2024-03-13 09:05:00,Long,1.0925,1.0924,1.0927,2,18700,100,,2024-03-13 09:05:00,18900,200,Win
123,2024-03-14 10:40:00,Long,1.09385,1.09377,1.0940100000000001,2,18900,100,,2024-03-14 10:40:00,18900,0,BreakEven
124,2024-03-15 12:00:00,Long,1.08916,1.08915,1.0891799999999996,2,18900,100,,2024-03-15 12:00:00,19100,200,Win
125,2024-03-20 13:35:00,Long,1.08386,1.08373,1.08412,2,19100,100,,2024-03-20 13:35:00,19100,0,BreakEven
126,2024-03-22 14:20:00,Long,1.082,1.08189,1.0822200000000002,2,19100,100,,2024-03-22 14:20:00,19000,-100,Lose
127,2024-03-25 08:00:00,Long,1.08159,1.08119,1.08239,2,19000,100,,2024-03-25 08:00:00,18900,-100,Lose
128,2024-03-26 11:25:00,Long,1.08548,1.08543,1.0855800000000002,2,18900,100,,2024-03-26 11:25:00,19100,200,Win
129,2024-03-27 10:00:00,Long,1.0828,1.0826,1.0832,2,19100,100,,2024-03-27 10:00:00,19000,-100,Lose
130,2024-03-28 14:45:00,Long,1.08002,1.07977,1.0805200000000001,2,19000,100,,2024-03-28 14:45:00,19200,200,Win
131,2024-03-29 12:20:00,Long,1.07847,1.07847,1.07847,2,19200,100,,2024-03-29 12:20:00,19400,200,Win
132,2024-04-01 12:10:00,Long,1.07795,1.07793,1.0779899999999998,2,19400,100,,2024-04-01 12:10:00,19600,200,Win
133,2024-04-02 08:30:00,Long,1.07313,1.07265,1.0740899999999995,2,19600,100,,2024-04-02 08:30:00,19500,-100,Lose
134,2024-04-03 12:40:00,Long,1.07759,1.07745,1.07787,2,19500,100,,2024-04-03 12:40:00,19400,-100,Lose
135,2024-04-05 09:10:00,Long,1.08363,1.08349,1.0839100000000002,2,19400,100,,2024-04-05 09:10:00,19300,-100,Lose
136,2024-04-08 08:15:00,Long,1.08301,1.08301,1.08301,2,19300,100,,2024-04-08 08:15:00,19500,200,Win
137,2024-04-09 18:45:00,Long,1.08518,1.08511,1.08532,2,19500,100,,2024-04-09 18:45:00,19400,-100,Lose
138,2024-04-10 11:30:00,Long,1.08624,1.08622,1.0862800000000004,2,19400,100,,2024-04-10 11:30:00,19600,200,Win
139,2024-04-11 09:05:00,Long,1.07349,1.07345,1.0735700000000001,2,19600,100,,2024-04-11 09:05:00,19800,200,Win
140,2024-04-12 18:35:00,Long,1.06404,1.06403,1.0640600000000002,2,19800,100,,2024-04-12 18:35:00,20000,200,Win
141,2024-04-15 11:45:00,Long,1.06547,1.06536,1.0656899999999996,2,20000,100,,2024-04-15 11:45:00,20200,200,Win
142,2024-04-16 13:10:00,Long,1.0632,1.06318,1.0632399999999997,2,20200,100,,2024-04-16 13:10:00,20400,200,Win
143,2024-04-17 10:35:00,Long,1.06414,1.06403,1.0643600000000002,2,20400,100,,2024-04-17 10:35:00,20600,200,Win
144,2024-04-18 11:30:00,Long,1.06719,1.067,1.0675700000000004,2,20600,100,,2024-04-18 11:30:00,20500,-100,Lose
145,2024-04-19 08:45:00,Long,1.0645,1.06436,1.06478,2,20500,100,,2024-04-19 08:45:00,20400,-100,Lose
146,2024-04-22 09:40:00,Long,1.06521,1.06512,1.0653899999999998,2,20400,100,,2024-04-22 09:40:00,20300,-100,Lose
147,2024-04-23 19:00:00,Long,1.07031,1.07026,1.0704100000000003,2,20300,100,,2024-04-23 19:00:00,20500,200,Win
148,2024-04-24 12:40:00,Long,1.0682,1.0681,1.0684,2,20500,100,,2024-04-24 12:40:00,20700,200,Win
149,2024-04-25 18:05:00,Long,1.07276,1.07252,1.07324,2,20700,100,,2024-04-25 18:05:00,20600,-100,Lose
150,2024-04-26 19:35:00,Long,1.0698,1.0698,1.0698,2,20600,100,,2024-04-26 19:35:00,20800,200,Win
151,2024-04-29 08:35:00,Long,1.07112,1.0711,1.0711600000000003,2,20800,100,,2024-04-29 08:35:00,21000,200,Win
152,2024-04-30 11:05:00,Long,1.07211,1.0721,1.0721299999999996,2,21000,100,,2024-04-30 11:05:00,21200,200,Win
153,2024-05-01 10:15:00,Long,1.06682,1.06673,1.0670000000000004,2,21200,100,,2024-05-01 10:15:00,21100,-100,Lose
154,2024-05-02 08:05:00,Long,1.07157,1.07149,1.0717299999999996,2,21100,100,,2024-05-02 08:05:00,21300,200,Win
155,2024-05-03 10:20:00,Long,1.07424,1.07418,1.0743600000000004,2,21300,100,,2024-05-03 10:20:00,21500,200,Win
156,2024-05-06 08:00:00,Long,1.07626,1.07576,1.0772599999999999,2,21500,100,,2024-05-06 08:00:00,21400,-100,Lose
157,2024-05-07 14:25:00,Long,1.07768,1.07749,1.0780599999999998,2,21400,100,,2024-05-07 14:25:00,21300,-100,Lose
158,2024-05-08 11:20:00,Long,1.07483,1.07471,1.0750699999999997,2,21300,100,,2024-05-08 11:20:00,21200,-100,Lose
159,2024-05-09 18:25:00,Short,1.07783,1.07785,1.0777900000000002,2,21200,100,,2024-05-09 18:25:00,21400,200,Win
160,2024-05-10 09:55:00,Long,1.07797,1.07791,1.0780900000000004,2,21400,100,,2024-05-10 09:55:00,21600,200,Win
161,2024-05-13 14:20:00,Long,1.08004,1.07988,1.0803599999999998,2,21600,100,,2024-05-13 14:20:00,21500,-100,Lose
162,2024-05-14 08:00:00,Long,1.0784,1.07838,1.0784400000000003,2,21500,100,,2024-05-14 08:00:00,21700,200,Win
163,2024-05-15 08:05:00,Long,1.08274,1.08254,1.08314,2,21700,100,,2024-05-15 08:05:00,21600,-100,Lose
164,2024-05-16 10:30:00,Long,1.08687,1.08664,1.08733,2,21600,100,,2024-05-16 10:30:00,21500,-100,Lose
165,2024-05-20 11:05:00,Long,1.08665,1.08665,1.08665,2,21500,100,,2024-05-20 11:05:00,21700,200,Win
166,2024-05-21 08:15:00,Long,1.0861,1.08603,1.08624,2,21700,100,,2024-05-21 08:15:00,21700,0,BreakEven
167,2024-05-22 15:05:00,Long,1.08353,1.08344,1.0837100000000004,2,21700,100,,2024-05-22 15:05:00,21700,0,BreakEven
168,2024-05-23 11:45:00,Short,1.08481,1.08484,1.08475,2,21700,100,,2024-05-23 11:45:00,21900,200,Win
169,2024-05-24 16:55:00,Long,1.0847,1.08464,1.08482,2,21900,100,,2024-05-24 16:55:00,22100,200,Win
170,2024-05-27 11:55:00,Long,1.08573,1.08565,1.0858900000000002,2,22100,100,,2024-05-27 11:55:00,22300,200,Win
171,2024-05-30 12:10:00,Long,1.08139,1.08137,1.0814300000000003,2,22300,100,,2024-05-30 12:10:00,22500,200,Win
172,2024-05-31 12:00:00,Long,1.08506,1.08506,1.08506,2,22500,100,,2024-05-31 12:00:00,22700,200,Win
173,2024-06-04 11:45:00,Long,1.08627,1.08609,1.0866300000000002,2,22700,100,,2024-06-04 11:45:00,22600,-100,Lose
174,2024-06-05 09:10:00,Long,1.08727,1.08714,1.0875299999999999,2,22600,100,,2024-06-05 09:10:00,22500,-100,Lose
175,2024-06-06 14:25:00,Long,1.08747,1.08728,1.0878499999999998,2,22500,100,,2024-06-06 14:25:00,22400,-100,Lose
176,2024-06-07 18:10:00,Long,1.0801,1.08009,1.0801200000000002,2,22400,100,,2024-06-07 18:10:00,22600,200,Win
177,2024-06-11 14:40:00,Long,1.07242,1.07227,1.0727199999999997,2,22600,100,,2024-06-11 14:40:00,22800,200,Win
178,2024-06-14 17:40:00,Long,1.06989,1.06987,1.0699299999999998,2,22800,100,,2024-06-14 17:40:00,23000,200,Win
179,2024-06-17 14:50:00,Long,1.07146,1.07138,1.0716200000000002,2,23000,100,,2024-06-17 14:50:00,23200,200,Win
180,2024-06-18 15:00:00,Long,1.07413,1.0737,1.07499,2,23200,100,,2024-06-18 15:00:00,23100,-100,Lose
181,2024-06-19 09:55:00,Long,1.07371,1.07362,1.0738899999999998,2,23100,100,,2024-06-19 09:55:00,23300,200,Win
182,2024-06-21 09:15:00,Long,1.06843,1.06833,1.06863,2,23300,100,,2024-06-21 09:15:00,23500,200,Win
183,2024-06-24 12:40:00,Long,1.07274,1.07262,1.0729800000000003,2,23500,100,,2024-06-24 12:40:00,23700,200,Win
184,2024-06-25 20:00:00,Long,1.07137,1.07134,1.0714299999999999,2,23700,100,,2024-06-25 20:00:00,23900,200,Win
185,2024-06-26 12:45:00,Long,1.06786,1.06785,1.0678800000000002,2,23900,100,,2024-06-26 12:45:00,24100,200,Win
186,2024-06-27 17:35:00,Short,1.07055,1.07056,1.0705299999999998,2,24100,100,,2024-06-27 17:35:00,24300,200,Win
187,2024-06-28 14:25:00,Long,1.07008,1.07008,1.07008,2,24300,100,,2024-06-28 14:25:00,24500,200,Win
188,2024-07-02 09:25:00,Long,1.07154,1.07151,1.0715999999999999,2,24500,100,,2024-07-02 09:25:00,24700,200,Win
189,2024-07-03 09:20:00,Long,1.07591,1.07587,1.0759899999999996,2,24700,100,,2024-07-03 09:20:00,24900,200,Win
190,2024-07-04 11:20:00,Long,1.07962,1.07961,1.0796400000000002,2,24900,100,,2024-07-04 11:20:00,25100,200,Win
191,2024-07-05 09:45:00,Long,1.0827,1.08268,1.0827399999999998,2,25100,100,,2024-07-05 09:45:00,25300,200,Win
192,2024-07-09 11:10:00,Long,1.08199,1.0819,1.0821699999999999,2,25300,100,,2024-07-09 11:10:00,25200,-100,Lose
193,2024-07-10 10:05:00,Long,1.08159,1.08134,1.0820900000000002,2,25200,100,,2024-07-10 10:05:00,25100,-100,Lose
194,2024-07-11 12:25:00,Long,1.08478,1.08443,1.0854800000000002,2,25100,100,,2024-07-11 12:25:00,25000,-100,Lose
195,2024-07-12 18:45:00,Short,1.0905,1.09054,1.09042,2,25000,100,,2024-07-12 18:45:00,25200,200,Win
196,2024-07-15 10:45:00,Long,1.09095,1.09081,1.0912300000000001,2,25200,100,,2024-07-15 10:45:00,25100,-100,Lose
197,2024-07-16 09:35:00,Long,1.08951,1.08948,1.08957,2,25100,100,,2024-07-16 09:35:00,25300,200,Win
198,2024-07-17 17:10:00,Short,1.09306,1.09316,1.09286,2,25300,100,,2024-07-17 17:10:00,25500,200,Win
199,2024-07-18 12:50:00,Long,1.09259,1.09253,1.0927099999999998,2,25500,100,,2024-07-18 12:50:00,25700,200,Win
200,2024-07-19 08:00:00,Long,1.08837,1.08793,1.08925,2,25700,100,,2024-07-19 08:00:00,25600,-100,Lose
201,2024-07-22 14:05:00,Long,1.0878,1.08777,1.0878600000000005,2,25600,100,,2024-07-22 14:05:00,25800,200,Win
202,2024-07-23 09:00:00,Long,1.08737,1.08733,1.08745,2,25800,100,,2024-07-23 09:00:00,26000,200,Win
203,2024-07-25 10:40:00,Long,1.08486,1.08481,1.0849599999999997,2,26000,100,,2024-07-25 10:40:00,26200,200,Win
204,2024-07-26 12:25:00,Long,1.08538,1.08535,1.08544,2,26200,100,,2024-07-26 12:25:00,26400,200,Win
205,2024-07-30 10:55:00,Long,1.08332,1.08332,1.08332,2,26400,100,,2024-07-30 10:55:00,26600,200,Win
206,2024-07-31 08:00:00,Long,1.08129,1.08126,1.08135,2,26600,100,,2024-07-31 08:00:00,26800,200,Win
207,2024-08-01 13:10:00,Long,1.07888,1.07877,1.0791000000000002,2,26800,100,,2024-08-01 13:10:00,27000,200,Win
208,2024-08-02 10:45:00,Short,1.08224,1.08225,1.0822200000000004,2,27000,100,,2024-08-02 10:45:00,27200,200,Win
209,2024-08-06 15:50:00,Long,1.09233,1.09222,1.0925500000000001,2,27200,100,,2024-08-06 15:50:00,27400,200,Win
210,2024-08-07 12:25:00,Long,1.09144,1.09144,1.09144,2,27400,100,,2024-08-07 12:25:00,27600,200,Win
211,2024-08-08 08:35:00,Long,1.09383,1.09369,1.0941100000000001,2,27600,100,,2024-08-08 08:35:00,27500,-100,Lose
212,2024-08-09 10:55:00,Long,1.09174,1.09174,1.09174,2,27500,100,,2024-08-09 10:55:00,27700,200,Win
213,2024-08-12 08:00:00,Long,1.09213,1.09207,1.09225,2,27700,100,,2024-08-12 08:00:00,27900,200,Win
214,2024-08-14 15:10:00,Long,1.1027,1.10268,1.1027399999999998,2,27900,100,,2024-08-14 15:10:00,28100,200,Win
215,2024-08-16 08:50:00,Long,1.09823,1.09806,1.09857,2,28100,100,,2024-08-16 08:50:00,28000,-100,Lose
216,2024-08-19 08:40:00,Long,1.10387,1.10368,1.1042499999999997,2,28000,100,,2024-08-19 08:40:00,28000,0,BreakEven
217,2024-08-20 11:40:00,Long,1.10776,1.10775,1.1077800000000002,2,28000,100,,2024-08-20 11:40:00,28200,200,Win
218,2024-08-21 09:45:00,Long,1.11138,1.11135,1.11144,2,28200,100,,2024-08-21 09:45:00,28400,200,Win
219,2024-08-22 11:20:00,Long,1.11358,1.11345,1.11384,2,28400,100,,2024-08-22 11:20:00,28600,200,Win
220,2024-08-23 12:30:00,Long,1.11137,1.11137,1.11137,2,28600,100,,2024-08-23 12:30:00,28800,200,Win
221,2024-08-26 08:45:00,Long,1.11808,1.11801,1.11822,2,28800,100,,2024-08-26 08:45:00,29000,200,Win
222,2024-08-27 09:55:00,Long,1.11681,1.1168,1.1168300000000002,2,29000,100,,2024-08-27 09:55:00,29200,200,Win
223,2024-08-28 13:55:00,Long,1.11111,1.11105,1.11123,2,29200,100,,2024-08-28 13:55:00,29400,200,Win
224,2024-08-30 19:40:00,Long,1.10494,1.10491,1.105,2,29400,100,,2024-08-30 19:40:00,29600,200,Win
225,2024-09-02 09:55:00,Long,1.1069,1.10676,1.10718,2,29600,100,,2024-09-02 09:55:00,29500,-100,Lose
226,2024-09-04 08:10:00,Long,1.10511,1.10496,1.1054100000000002,2,29500,100,,2024-09-04 08:10:00,29400,-100,Lose
227,2024-09-05 11:55:00,Long,1.1095,1.1093,1.1098999999999999,2,29400,100,,2024-09-05 11:55:00,29300,-100,Lose
228,2024-09-06 09:05:00,Long,1.1113,1.11109,1.11172,2,29300,100,,2024-09-06 09:05:00,29200,-100,Lose
229,2024-09-09 14:10:00,Long,1.10381,1.10344,1.10455,2,29200,100,,2024-09-09 14:10:00,29100,-100,Lose
230,2024-09-10 11:30:00,Long,1.1035,1.1034,1.1037,2,29100,100,,2024-09-10 11:30:00,29000,-100,Lose
231,2024-09-12 11:30:00,Long,1.10174,1.10171,1.1018,2,29000,100,,2024-09-12 11:30:00,29200,200,Win
232,2024-09-13 10:10:00,Long,1.10903,1.1088,1.1094899999999999,2,29200,100,,2024-09-13 10:10:00,29100,-100,Lose
233,2024-09-16 09:50:00,Long,1.11193,1.11181,1.1121700000000003,2,29100,100,,2024-09-16 09:50:00,29100,0,BreakEven
234,2024-09-17 17:05:00,Long,1.11139,1.11138,1.1114100000000002,2,29100,100,,2024-09-17 17:05:00,29300,200,Win
235,2024-09-18 19:15:00,Long,1.11406,1.11365,1.11488,2,29300,100,,2024-09-18 19:15:00,29300,0,BreakEven
236,2024-09-19 19:15:00,Long,1.11609,1.11601,1.1162500000000002,2,29300,100,,2024-09-19 19:15:00,29500,200,Win
237,2024-09-23 15:55:00,Long,1.11302,1.11262,1.1138199999999998,2,29500,100,,2024-09-23 15:55:00,29400,-100,Lose
238,2024-09-24 15:45:00,Long,1.11482,1.11467,1.1151199999999997,2,29400,100,,2024-09-24 15:45:00,29300,-100,Lose
239,2024-09-26 18:40:00,Long,1.11766,1.11734,1.1183000000000003,2,29300,100,,2024-09-26 18:40:00,29200,-100,Lose
240,2024-09-27 12:00:00,Long,1.11609,1.11584,1.1165900000000002,2,29200,100,,2024-09-27 12:00:00,29100,-100,Lose
241,2024-09-30 12:25:00,Long,1.11919,1.11899,1.1195899999999999,2,29100,100,,2024-09-30 12:25:00,29000,-100,Lose
242,2024-10-01 15:05:00,Long,1.10631,1.1063,1.1063299999999996,2,29000,100,,2024-10-01 15:05:00,29200,200,Win
243,2024-10-02 09:10:00,Long,1.10662,1.10652,1.10682,2,29200,100,,2024-10-02 09:10:00,29400,200,Win
244,2024-10-03 10:00:00,Long,1.1039,1.10354,1.1046200000000004,2,29400,100,,2024-10-03 10:00:00,29300,-100,Lose
245,2024-10-04 12:15:00,Long,1.10285,1.10262,1.1033100000000005,2,29300,100,,2024-10-04 12:15:00,29200,-100,Lose
246,2024-10-07 09:05:00,Long,1.09637,1.09637,1.09637,2,29200,100,,2024-10-07 09:05:00,29400,200,Win
247,2024-10-08 09:50:00,Long,1.0987,1.0987,1.0987,2,29400,100,,2024-10-08 09:50:00,29600,200,Win
248,2024-10-09 14:35:00,Long,1.09483,1.09483,1.09483,2,29600,100,,2024-10-09 14:35:00,29800,200,Win
249,2024-10-10 08:05:00,Long,1.09324,1.09323,1.0932600000000001,2,29800,100,,2024-10-10 08:05:00,30000,200,Win
250,2024-10-11 12:50:00,Long,1.09272,1.0926,1.0929599999999997,2,30000,100,,2024-10-11 12:50:00,30000,0,BreakEven
251,2024-10-14 08:55:00,Long,1.09268,1.09236,1.0933200000000003,2,30000,100,,2024-10-14 08:55:00,29900,-100,Lose
252,2024-10-15 10:30:00,Long,1.09095,1.09084,1.0911700000000002,2,29900,100,,2024-10-15 10:30:00,30100,200,Win
253,2024-10-17 08:35:00,Long,1.08504,1.08503,1.0850600000000001,2,30100,100,,2024-10-17 08:35:00,30300,200,Win
254,2024-10-18 08:35:00,Long,1.08371,1.0837,1.0837299999999996,2,30300,100,,2024-10-18 08:35:00,30500,200,Win
255,2024-10-22 08:40:00,Long,1.08294,1.08268,1.0834599999999999,2,30500,100,,2024-10-22 08:40:00,30400,-100,Lose
256,2024-10-23 16:00:00,Long,1.07773,1.07766,1.07787,2,30400,100,,2024-10-23 16:00:00,30600,200,Win
257,2024-10-25 13:40:00,Long,1.0828,1.08267,1.08306,2,30600,100,,2024-10-25 13:40:00,30500,-100,Lose
258,2024-10-28 09:50:00,Long,1.08114,1.08084,1.08174,2,30500,100,,2024-10-28 09:50:00,30400,-100,Lose
259,2024-10-29 10:05:00,Long,1.08169,1.08166,1.08175,2,30400,100,,2024-10-29 10:05:00,30600,200,Win
260,2024-10-30 10:25:00,Long,1.08383,1.08378,1.0839300000000003,2,30600,100,,2024-10-30 10:25:00,30800,200,Win
261,2024-10-31 09:05:00,Long,1.08558,1.08542,1.0858999999999999,2,30800,100,,2024-10-31 09:05:00,31000,200,Win
262,2024-11-04 08:45:00,Long,1.08901,1.08892,1.0891899999999999,2,31000,100,,2024-11-04 08:45:00,31200,200,Win
263,2024-11-05 09:50:00,Long,1.08912,1.08912,1.08912,2,31200,100,,2024-11-05 09:50:00,31400,200,Win
264,2024-11-06 17:50:00,Long,1.07287,1.07286,1.0728900000000001,2,31400,100,,2024-11-06 17:50:00,31600,200,Win
265,2024-11-07 09:20:00,Long,1.07589,1.07578,1.0761100000000001,2,31600,100,,2024-11-07 09:20:00,31800,200,Win
266,2024-11-08 08:00:00,Long,1.07687,1.07665,1.0773099999999998,2,31800,100,,2024-11-08 08:00:00,32000,200,Win
267,2024-11-11 10:55:00,Long,1.06719,1.06708,1.0674100000000002,2,32000,100,,2024-11-11 10:55:00,32200,200,Win
268,2024-11-12 12:05:00,Long,1.06124,1.06124,1.06124,2,32200,100,,2024-11-12 12:05:00,32400,200,Win
269,2024-11-13 18:05:00,Long,1.05581,1.05581,1.05581,2,32400,100,,2024-11-13 18:05:00,32600,200,Win
270,2024-11-14 08:30:00,Long,1.05457,1.0541,1.05551,2,32600,100,,2024-11-14 08:30:00,32500,-100,Lose
271,2024-11-15 12:20:00,Long,1.05715,1.057,1.0574500000000002,2,32500,100,,2024-11-15 12:20:00,32400,-100,Lose
272,2024-11-18 10:25:00,Long,1.05499,1.05488,1.0552100000000002,2,32400,100,,2024-11-18 10:25:00,32600,200,Win
273,2024-11-19 14:55:00,Long,1.05725,1.05701,1.05773,2,32600,100,,2024-11-19 14:55:00,32500,-100,Lose
274,2024-11-21 14:25:00,Long,1.05262,1.0525,1.0528599999999997,2,32500,100,,2024-11-21 14:25:00,32700,200,Win
275,2024-11-26 11:25:00,Long,1.05079,1.0505,1.0513699999999997,2,32700,100,,2024-11-26 11:25:00,32600,-100,Lose
276,2024-11-27 10:20:00,Long,1.05149,1.05129,1.05189,2,32600,100,,2024-11-27 10:20:00,32800,200,Win
277,2024-11-28 09:25:00,Long,1.05355,1.05344,1.05377,2,32800,100,,2024-11-28 09:25:00,33000,200,Win
278,2024-11-29 15:25:00,Long,1.05475,1.05471,1.0548300000000002,2,33000,100,,2024-11-29 15:25:00,33200,200,Win
279,2024-12-02 19:45:00,Long,1.04906,1.04901,1.0491600000000003,2,33200,100,,2024-12-02 19:45:00,33400,200,Win
280,2024-12-03 10:05:00,Short,1.05235,1.05238,1.0522899999999995,2,33400,100,,2024-12-03 10:05:00,33600,200,Win
281,2024-12-05 09:00:00,Long,1.05325,1.05275,1.05425,2,33600,100,,2024-12-05 09:00:00,33500,-100,Lose
282,2024-12-06 17:00:00,Long,1.05531,1.05531,1.05531,2,33500,100,,2024-12-06 17:00:00,33700,200,Win
283,2024-12-09 09:55:00,Long,1.05661,1.05625,1.0573300000000003,2,33700,100,,2024-12-09 09:55:00,33600,-100,Lose
284,2024-12-10 14:55:00,Long,1.05196,1.05193,1.05202,2,33600,100,,2024-12-10 14:55:00,33800,200,Win
285,2024-12-11 14:30:00,Long,1.05058,1.05004,1.05166,2,33800,100,,2024-12-11 14:30:00,33700,-100,Lose
286,2024-12-12 15:30:00,Long,1.04751,1.04743,1.0476699999999997,2,33700,100,,2024-12-12 15:30:00,33900,200,Win
287,2024-12-13 12:20:00,Long,1.0492,1.04916,1.0492799999999995,2,33900,100,,2024-12-13 12:20:00,34100,200,Win
288,2024-12-16 08:55:00,Long,1.05083,1.05066,1.05117,2,34100,100,,2024-12-16 08:55:00,34000,-100,Lose
289,2024-12-17 15:35:00,Long,1.05037,1.04997,1.05117,2,34000,100,,2024-12-17 15:35:00,33900,-100,Lose
290,2024-12-18 10:25:00,Long,1.04894,1.0489,1.04902,2,33900,100,,2024-12-18 10:25:00,34100,200,Win
